...............##
####...........##
###..............
#................
##............#..
#.....##........#
#..........####..
#................
#################